############################
#************##************#
#*####*#####*##*#####*####*#
#*####*#####*##*#####*####*#
#*####*#####*##*#####*####*#
#**************************#
#*####*##*########*##*####*#
#*####*##*########*##*####*#
#******##****##****##******#
######*##### ## #####*######
######*##### ## #####*######
######*##          ##*######
######*## ###__### ##*######
######*## #      # ##*######
      *   #      #   *      
######*## #      # ##*######
######*## ######## ##*######
######*##          ##*######
######*## ######## ##*######
######*## ######## ##*######
#************##************#
#*####*#####*##*#####*####*#
#*####*#####*##*#####*####*#
#***##*******  *******##***#
###*##*##*########*##*##*###
###*##*##*########*##*##*###
#******##****##****##******#
#*##########*##*##########*#
#*##########*##*##########*#
#**************************#
############################