############################
#            ##            #
# #### ##### ## ##### #### #
# #### ##### ## ##### #### #
# #### ##### ## ##### #### #
#                          #
# #### ## ######## ## #### #
# #### ## ######## ## #### #
#      ##    ##    ##      #
###### ##### ## ##### ######
###### ##### ## ##### ######
###### ##          ## ######
###### ## ######## ## ######
###### ## ######## ## ######
          ########          
###### ## ######## ## ######
###### ## ######## ## ######
###### ##          ## ######
###### ## ######## ## ######
###### ## ######## ## ######
#            ##      ******#
# #### ##### ## #####*#### #
# #### ##### ## #####*#### #
#   ##         *******##   #
### ## ## ######## ## ## ###
### ## ## ######## ## ## ###
#      ##    ##    ##      #
# ########## ## ########## #
# ########## ## ########## #
#                          #
############################